xxm ιιιιιιιιιιο

Cartapini — Saluo - Dic - Verum - Oeagro - Ecquem - Siqui-
dem -’ Tu quaeris - Me csse -- Apertum — Hospes - Eupo -
Hospitium — Di -— Cartapini - Surruptus — Me — sed — Parentum
- Memorandum — Amsipuru - Matrem — Quod — 'Pater - Cun
serum - Sed si — tundenti — Audi atquc - Item - Bene — Paterna
— (luc — Suam - Et si — Festiuum — Tuo est- Vt uolnss
Inimico —- Huius -— Sapienter — Ei - Efflr'etim — Amulio - Htt
illi - Consilium — Filios — Marm - Impellepe's - Cum — Aer-
mulos — Vellem — Est olli dum - Facilius - Sed - Haud- lt·
ιιιιεια - Formam - l'idere Meae — Heus - Qui illam

uis- Mouistiu - Epo — Mearum — Ecce- Perduur't - Ιιι·Ι
sperastis-sume — Mirari — Ancillam - Apud - Aphrodisia - sm
— Adest — Tua - Tem-porc - Iudipnum - Bene - quidmi-
Hpc autem - Que eu — Tu - Fac — Doctissirne ''. Patruo -up
- Codicem - Arulin — Respondeas - Sporuleo - Nune - Τιιι
- Quid - p biterta - Epo — Ipsos — Scin - Opinor - Et sc
uerum - Pol - Intro

uit- 1179. Arabius - Sordere - clientarum - Certo — Parnm
- Habitfie — Aliis - thol — 1191. Ouinia — Tace —Soror -
I’ucbritudine - Videre - Cpatruc — Gnate quiduis - Istuc ν-
l'tsapit — 1203. Multa - Placent- Inertis - Dixit- Domino-
Farint - Patricoles - Soror - Clarnabas - Vuu - Amicus -
Mea - Amittio - Multa — Gaudio - libertatique — Ita ιιιι -
Illum — 1⁸-ooamoeno-Hereumsistant-luzisos—Hanc —
Jam— Ite— -Qur'dcm— Moramini'- Quid- Etiam -
D-ato canon-hbuit nos— Vos- Ropalo- Atque- 1245155
predicubo- Huins— surruptas — Qrein - Sit —- Mulieres- Eue-
nirc —- Eas — Decoronlque — Huiusce — Ita di - Nobis - erum

-- Post ea — Hac- Credatis — Apud — Mebi - Littera - Bra·
ahialon — Tandem — Cur — Nibil - Vobis — Adsecistis —— Mt
Habeas- Et dotis

r'cpo — Me -— Adduuit - Vbi — Parte κ Tetipero - Sar -
Iam pol —- Ita — Cortinum - Voluptas - Auserat — Epo - Sed
— 1304. Sed - Jnoo -- Adulescens — Dipito — Lipula — Aut -
Sementium — dtu ulpicique — Mulp— Cur uon — Esse- Iste istinc
— Diui - :luto pecuedes — Noster — Ito — Siquidem - Obtipit --
Credo - Eccum - Est et — Auri -— Intus - Iniuriarum

eripitur - Narrat - l't me — Obsecro — Voco - Iupeuuasque
— Iam - Istas - Inluseas — Prossrto - Multis — Minimum -
Colorem - Numquid — Mulieres — Haud - Arabonem — Haud —

Pretorc - 'l'reccntos — Tantisper — Sequere - Huius — Malum -
Condimentum

am — Mernircre - Suus - thipr‘t - Curtlrapineuses — Semper
—- l'e - Qui - At - Nouelle - Auri — Ropuecm - Quinorunt
— Et leurrc —- Vt bonos - Iam — Eas — Reddam — Nilu'l -
Epomct — Heus- l'tr'nom - Di - Aurum - Quid —- Si — thurin·
terne— Ne'pater— Ausculto — Hoc ope — Non -- Lento -— Iam -*
-Idnti— Ito —Leno- rfss-rn Nescias— Dabo - Foeta

——D um— bociam

 

