χχιι PRAEFATIO

sulse — Coqua est -· V t raaceret - Sat- Quiesce - Omnia - Dim

-- ltiauum - Ec quid — Cedo - Vt eqo - Amem - Toeeo — ΟΜ

- Veneris- Turba est - Proseela - Miseros - Οαρ tibi - Quos
redeo - Dormem - L iu malam - Pro sidium — Ee monstrum -
Quo uis- Dii - Quid — Qui baec - Hauc - Milphio mar - At
rao — Haec didici — Tetiqem's - Quibus - Aspieio - Iaraao - Nan
pro — 295. I iu — Perpetuo - 323. At eoo -ΟΜ - Splendeat -
Cedo — Tractes - Qua de - Veneris — Noa — Prius - Sacru-
ficam - Ita - Milphio — Obsecro- Sisumam - Ecquid - Midiae
- addecet - Sequere — Adeas — Salue - Et oleum - Veneris -
Propitiis - Qreid milri — Quid - Eoo - Spectandum - Meretricum -.=
- Iaueadibili - Facite- Quid ais — Οιιο die - Neseio - bbb. lan
berete - Quam - Faciam - 361, Liberaret - Neque ammam - Ita
— Eo qaid — Mea araceuitas -- Seruium -— Meua -Iubeo - Sue· 5
cauere — Pro te — 379. Male - Aruabo - Trioboli - Eur uo x
luurptatem — Salutem — Iam - Eo quid — Erao — Voluptas -x
Liuyua -— blastiyia - Omnia - Obsecro - Mauemiata - Mea a:
Potest- 401. Aliquid - Nam - Noeiam - Da ereo - 1 erac: ,
- Veneri - Atque - Respice

uid - Auctionem — Hasce — Habitus - Trecentos - Naue -ω
Leuom - Perque - Disce (lililpbi Disce) - Mihi — Adduce - Er
sicopboatis - b'aaio - Eyaue -τ Eyo te - Non berete -· Ameneia
est - Aqua ia — Peraia· - Neque boc — Opus si — Neam berete
- Dicam —- Vide - Hebraei - Opus - Abiit - Moram - He
oboedientem

iillum - umquam — Saaufieauerit - Sea — Facere - Iratus
- Nou boba - Eo - Quod ,sat - Sic me — Meae - Cotidiana -
Porteudi - Quid ei - Ardeati — Miles — Sed ee auur — Lenuite-
Vao - Horreimum - Suae — Quomodo — Fuadasaue — Ne ad -
Peri uras — Globas - Verba - decidebant — Per - quaam -
Sacruficem — Credo - Exta — Nihil - Elidem - Malam - Tum
tu - Meretricem — (tenuis — Decretum est - Sequor

ta me — 607. 'tardiores - Equidem — Aetati ’- Procas — lte'
caedite — Homini — Saceretu est - Et pauperes - Audacter -
Summis - Dedimus — Nos -- Causeas - Ire — Placido - Peope
rubas - Netu opimae — blein - Gradu — Si (Podaqrosii - Quo
curratur - Vsque - Sed tamen — 550. Omnia - Nune causa —
Docere — Scimus — Vua — Iaiiur - ltane — Quomodo - Deferret
- Persaeirmm - Seruum - Seruastis - Id duplicabit - Nos esse
-Ita - Aee-redum — Te aduocatus - (sptium - Femina - At
ocielos — Quod dici — Iniuste — Galleraus - Tenetis

iam tenes — 582. Probus - Tot quidem — 586. Hodie — Si mibii
— Vos — Et beue — 596. Vt sciamus - Aurum est -· Pineum -
elain derat — Sed ita - Scilicet - Oraueris - Voluptariam — liu
edepol - Porro - Mecum — obiciatur - Habeamus - Mortales -
St tace — Modo- Perduiat — Faciunt - Illic - Malus est

am istuc — Corrrrrrodas - Mulieres- Huc — Et ille - Aetolici ,
—- Irruiti - Fortunati — Sitaturam — Vt - Deueuiat - Eae -
Vos certam est — st raeda - Si periculum - Scies — Male faciae -
Aliiml — Qeearreauam - Siquid - Nee feriatus — Credo - Hm

 

