Ι PRAEFATIO XIII

tramitti I- saras Ι —- ferreis Ι .- seram —- inpinai - itane —
indicet Ι — nasicas - nocta — hinc noio - hanc — pamiae -
tamqnam - ocrtnf -snit - tibi comta - aitte i - mers
eti - ancre - nelle ·- mancupio — damnas - hercle -
atinate, — dard - leno — aeras 1 ’

597-622τ - parantibus Ι - inpntfn meo Ι - manime Ι -
noya Ι - dare - adire ot — nolo - tabet Ι - aare} - im- .
pera Ι - auspitium — cae — adduco — perconctarier Ι -
meam-acaum - thiibidem—heuftn-fcioeyo-
eloquar Ι - apnd tnnc -, snam Ι - percontabimur Ι - id
mirer — nequid mirer — callida Ι

623-647: -qnid nomen - fnit Ι - emis Ι - quoa· —
numanam —- eat Ι —- addito Ι - mitri Ι - manum Ι - loco 1 -
scpifflme Ι — dicerit· Ι - tna Ι - qnaero - artando snit! —
oneras — equidem - tna - equidem patriam - dc istoc -
miseriorum -ὲ pater — bono — qais fnit -' qni snit Ι —
dominarier!

648-672: —acceptior Ι - praedicas Ι - arcam — ar·
bitror Ι - memodo Ι - fciet Ι - nanc - fractae - cades Ι -
nolo Ι - bolos! - tibi Ι —perdere Ι ,- indica Ι —- neinaf Ι -
hinc — actitem - minis Ι - qni hae - probe Ι - trecentis -
tanc — non accedent —- intectam nt — petis Ι - affero-t

673-682: — probam et - fit dc — obi — iomanem —
recipito Ι σ- arando - ,nce - foras Ι

683-71οε - minas est - facere - miter Ι - qnando —
dc’cm Ι - icoc fif — fiat - reeyotinncst Ι - antem — redimit -
videor — qnippe qni — feias Ι - arcendam — ceponio nides Ι
- nemea — mores - ‘cottis — potins — oola-t

Ill-729: - ittnnit κ itleqnidd - trandidit Ι - adsera-
tnr >- fore Ι - habeo - inemo send Ι - tiana — adncmieam
“- crhisti—tacel— satit

712-752: - [quaid - tibi Ι - atiicd - iarn cao -
tna Ι - aedes — dedit Ι -.- iaitar - scetid Ι - ambedo -
dicant - earnnfen Ι - nannetes — atributa Ι — artata - [aanor

753-777 : — extincto — inoliter — aaa — participet —
nosiinm — ponite - eqo ories — opera leaeo — cli horno -
mi cnr - aaa dic arao Ι - neaais — cirnerrdamns Ι -’ aaa
erqo · Ι - pepini Ι - inani Ι - mensam Ι - mnne —pro

 

