u

pessumo xxm

- Istuc — Cum reela - Iaplayas - Quidem - Istum -Salutat -
Iusicopbauticm - Ait - Preberier — Tu si - Aurum - Locum -
Neqsu's — Vtauielcm - Quoniam — Optume - Precipitis - Quo aa.
curres - Rea — Quidem - Aelme - Decet — Nos tibi — Capera —
Hospita - Illic - Vellem — Romam — Quorsum — Hospes -—
Didoni - Querito - Minime — Aelueicieas - Vbi eoo —· Edepol —
Pati - Oomplcxum -Leucadio — Iaciaes — Quid - Vnamtarium
- Qum ita - Accipere - Duc erqo — Huc abor. - Heus- l'ttute

uideat - aurum — numerati — Mino - Prodioium - Aac —
Namato κ Abduc — Estis - Esto - Eum - Populi — Comme-
minisse - Meminimus - Si pultem — Leno- Quippiai - Ibi -
Nummis - Qucuitaii — Iuratus - Id quidem — Quippiui — Ibo -—
Est nom — lycum - Ne aas

uspciedaut - Quodloquautur - Malum — Rem — Maais — Euenit
- Valcaut —' Postulatum — Adelphasium — Calidum — Quia —
&mum - Factum - lta — Me - Mementote — Hababa - Coa-
eiliaucmnt — Crebro (Cerebrum) '- Num — Adleqaueruat — Esse -
Adaeus — Ncoasnc - Siquid — (tieem tibi — Modo detulit - Vc —
Aac - Furos - Abboc - Consulto — Dubito - Adpretorem - Qui
si - Amicos — Genseaut

aotu - Estne — Quid -- Vtinam — Cras —- Abscedas ·- Factus
- Dormital - Factum - Cras — latro — Nostros — Siquid —
Plumbeas - Quando- thcreleremus

aspecto — Laconem - Is me - Seruice — Attal — Habeat

atie - 833. Verberatum - (anaia — Tenebre -Ibi -— Cubitum
— Ouinia - Illi - Etautem — Fieri - Seruos - Mala disperit —
Fruai — Numa — Erus - lepidam — Venerem — Nunc — Vocat
- (lisere — Vbi uoles - Operam — Tu corium - Malus suut —
Atta - Saluos — Quota uam - Queat ament — matta - Manu
festo - refero - Mc — Meum erum - lelcst — Memoraadum —
Quo dedis - Gratiis — Vt eoo - Sine - Nolito —— Erum - Verum
—- Quidiam - Tacitus — Animum- Orcele — Scimu — Propior -
Doctum - Meus -· Siquid - Metuo - Pari lem - Mortali -
Numquam - Nisi — Id csse - Saltu — Loquere Volet - Fa-
cile —- Quia - Eodem - Quia - Duo clouiyiuli - Duo elcuiyiati —
Etillc - Aiebat - Nam - Sex euciis - Cum bio - Omma -
Liberali — Redimet —- Calcem — Hunc -— Ita — l'ttibi —- Cura —
Ateaim - 925. Id ueootium -— Consulemlum - Inseruiemlum cst -

ui - Num

ρ 950. Deos - Huc - Repperire — Et fratris — Eum fecisse —
Hic - Mecum - Hos

iectu — Surrupticias -- Eas — Popularis — Pro — Hostilium —
Vt mibi- Testis — {litia tu insistis — Incipere - Illec - Circum·
eluctus — Seruos — Video —- Noa - Auribus — Pumice peccam -
Quid -— Nam — Pro — Perire — Ais - Hunc — Est dcam -
Quid uelit — Sit ae - alienon — llaauoaem — uo - Nescio -
Auo — Istuc — Baccam - Esse uolo — Sic — Opus -— Aut quid ——
Mululecleiamea —- Iapompam - Quid mem - Nunc oreti - Is sons

— Milphio - Quidem -— Nequiel - Mupboum'um — 1030. Seruum,
— Percqrimum — Hominem - Captatum - Maledicta -— Huic —-

 

