esuriemus m

- Quae babeat — Priusquam -· Socruficare - Ita suut- Edepol —
Nihil uisi - Ec quid — Num quidem - Aqe sis - Primum prima
- Salueertra - Quale - Elio am — Quid inibi — Seio - 3⁶2. Quid
eqo - Verba Quid ure uis versui 284 adhaerent - 403. Verum -
¹Vari sum — Mose - Adque audiri — Atque liae - Respexit —
[12. Ouidium - Quid uuuc - 418. Perque- Em - Fue- Per-
'ocele - Iam - Fuqio - Epa uc — Vt mou - Emittam - Quam-
um - Abiturus uc — Neque stellp - Neque berete — 469. Qui lianc
- Ita ut - Quo serapium - Ε uolaticarum - Au obsecro — Quo-
uodo- Fumdusque - Scitis (v. 547) υ 560. Isque - Vbi is - Me·
uiuisiis — Id dublieabit - Adrum - Vix - Hoq - Beue - Optime
— 621. Aetolici — Et quamquam - Fortunati — Istic - 700. Ibi te
- Ibi ut - 768. Ηα ba — Pereqriuuru - 1131. Nouis et — Quid
{rbi — Aphrodisia - Ora tum - Pol — Ebc - Ita - 1149. Sed
quis - Epo - Abeo — 1157. Pac lam — Spoudes ue — corriperem
- Nuuc — Iamdudum - Quid si - Praeterbit - Maque - Restitue
—· qu - Haecine — Scin - Opiuor — 1179. Arabius - Ooruplebat -
seusu — ραι ad — Atliuuit - Neque ab — Malim - Spero - Vt
pol- Eo sumus — 1191. Omuia - Tace- Ne lucruma - Sicut —
1195. si libi - opaerue - Quid est - At euim - Quid cst —- Iu·
qeuium - 1382. Quis liic - Iu seruitute - est ᾖ Bellum - Ye esse
- Qui moruut — Et bruto

Haeo autem 0:

10. Nimia est — lucedere η Sirium — Nam - Vt mercedem -
Scortum — Aut uirqe - Ducat - Auimo ‘— Liberis- Domum —
Er loris — Pueros - Afferaut — Hic quasi - Lactora - Conferant
-— Curatores — Niue - Bouis - Iupopiuaru 7— Nune dum — lm-
peria - Ad arquuzeutum - Siti siqua rures - Ei rei - Coruediuis
irradiari - Carchedonius - Narueu — Hic cerrsebitur - Vas — Pa-
trueles - Viuit - Quia milri - ruortuus cst — Puer - Quam -
Comicitur — Fratrem -Ille- Hieeliuiti — Emit- Adoptat - Is
illic — Caribaqiuem - Qui dederit - Sed illi- Altera quinqueremis
— A maqaribus — A sommis — Est bama — Vos met - Oui lico —
Huc ÷ Is inillis - Estlictum - Neque eam - Quo mea - Volui —
Illam - Qui illam — Marito - luqressus - Dat — Captaueaut -
ltu - Sed - Is beri - Idem huic - Ducite - Oblitus — Filio —
Veniet - Quidem - Hic qui —- Filium — Quod - Vt aas

epe — Iuopiosas — Mihi deberi — tempus - Quod —- Nurac -
Coutriuisti - Iqmoscere — Et rrurrc - Ob - Sitibi — Auctor — Dis·
solutus — Quia — Immo - Apud - Senti-out - Leuouis — Istuc
- Illius — Dare — Dic — Em - Locore - Tuam - Facias —
Satis — Tibi- Iam - Nauit -ι Nescio — Vt ad - Se amare —-
Preberier - Accipiet- Placet- (lucri — Duplici — Habet - Ita
-Immo - Rudest — Aphrodisia — Munditiis — Abeamus — Fal-
latiam — Tibi - Huic - Itaque — Ballistast - Sed- Erum -
Siuis - Em —- Cum boc

eqotii — Nam — Neque — Societas - Ab aurora —- Ec — La-
uari - Et uua — Eae- Operam — Apaqesis - Maxumo - Diesque
.. Postremo - Neque umquam - Nam — Miror 7- Et faceta — Via·
- Tarrrem - Niuu'a — Soror - Esse - Aqua - Nou uelis — Iu·

 

